---------+---------+---------+
                              $
         11111111             $
                              $
          9                   $
    1                         %
    1                         $
    1                         $
    1                         $
                              $
      3333                    %
            4                 $
       8    4                 $
            4        1        $
                    1         $
                    1         %
                    1         $
 1111111            1         $
                    1         $
        1111                  $
                       111    %
                              $
                              $
       111111111              $
                              $
                              %
   1111111111111111111        $
                              $
                              $
               1111111111111  $
                              %



